RRSRRRRRRRRRRRRRRRRRSRR
BSBBBBBBBBBBBBBBBBBBBSB
YYSYYYYYYYYYYYYYYYYYSYY
GGGSGGGGGGGGGGGGGGGSGGG
PPPPSPPPPPPPPPPPPPSRPPP
OOOOOSOOOOOOOOOOOSOOOOO